11111111111111111111111111111111111111111111111111
11111111111111111111111111111111111111111111111111
11111111111111111111111111111111111111111111111111
11111111111111111111111111111111111111111111111111
11111111113333333333333333333333333333111111111111
11111111113333333333333333333333333333111111111111
11111111113333222222222222222222223333111111111111
11111111113333222222222222222222223333111111111111
11111111113333222222222222222222223333111111111111
11111111113333222222222222222222223333111111111111
11111111113333222222222222222222223333111111111111
11111111113333222222222222222222223333111111111111
11111111113333222222222222222222223333111111111111
11111111113333222222222222222222223333111111111111
11111111113333222222222222222222223333111111111111
11111111113333222222222222222222223333111111111111
11111111113333222222222222222222223333111111111111
11111111113333222222222222222222223333111111111111
11111111113333222222222222222222223333111111111111
11111111113333222222222222222222223333111111111111
11111111113333222222222222222222223333111111111111
11111111113333222222222222222222223333111111111111
11111111113333222222222222222222223333111111111111
11111111113333222222222222222222223333111111111111
11111111113333222222222222222222223333111111111111
11111111113333222222222222222222223333111111111111
11111111113333222222222222222222223333111111111111
11111111113333222222222222222222223333111111111111
11111111113333333333333333333333333333111111111111
11111111113333333333333333333333333333111111111111
11111111113333333333333333333333333333111111111111
11111111111111111111111111111111111111111111111111
11111111111111111111111111111111111111111111111111
11111111111111111111111111111111111111111111111111
11111111111111111111111111111111111111111111111111
11111111111111111111111111111111111111111111111111
11111111111111111111111111111111111111111111111111
11111111111111111111111111111111111111111111111111
11111111111111111111111111111111111111111111111111
11111111111111111111111111111111111111111111111111
11111111111111111111111111111111111111111111111111
11111111111111111111111111111111111111111111111111
11111111111111111111111111111111111111111111111111
11111111111111111111111111111111111111111111111111
11111111111111111111111111111111111111111111111111
11111111111111111111111111111111111111111111111111
11111111111111111111111111111111111111111111111111
11111111111111111111111111111111111111111111111111
11111111111111111111111111111111111111111111111111
11111111111111111111111111111111111111111111111111
