11111111111111111111111111111111111111111111111111
11111111111111111111111111111111111111111111111111
11111111111111111111111111111111111111111111111111
11111111111111111111111111111111111111111111111111
11111111113333333333333333333333111133333111111111
11111111113332222222222222222222111133333111111111
11111111113332222222222222222221111233333111111111
11111111113332222222222222222111111233333111111111
11111111113332222222222222111122333333333111111111
11111111113332222222222222111122333333333111111111
11111111113332222222222222111122223333333111111111
11111111113332222222222211112222333333333111111111
11111111113332222222222211112222222333333111111111
11111111113332222222222211112222222333333111111111
11111111113332222222211112222222333333333111111111
11111111113332222222211112222222333333333111111111
11111111113332222222211112222222222233333111111111
11111111113332222222211112222222222233333111111111
11111111113332222221111222222222223333333111111111
11111111113332222221111222222222222333333111111111
11111111113332222221111222222222222333333111111111
11111111113332221111222222222222333333333111111111
11111111113332221111222222222222222333333111111111
11111111113332221111222222222222222333333111111111
11111111113332221111222222222222222333333111111111
11111111113332221111222222222222222233333111111111
11111111113332221111222222222222222233333111111111
11111111113332221111222222222222222233333111111111
11111111113333331111333333333333333333333111111111
11111111113333331111333333333333333333333111111111
11111111111111111111111111111111111111111111111111
11111111111111111111111111111111111111111111111111
11111111111111111111111111111111111111111111111111
11111111111111111111111111111111111111111111111111
11111111111111111111111111111111111111111111111111
11111111111111111111111111111111111111111111111111
11111111111111111111111111111111111111111111111111
11111111111111111111111111111111111111111111111111
11111111111111111111111111111111111111111111111111
11111111111111111111111111111111111111111111111111
11111111111111111111111111111111111111111111111111
11111111111111111111111111111111111111111111111111
11111111111111111111111111111111111111111111111111
11111111111111111111111111111111111111111111111111
11111111111111111111111111111111111111111111111111
11111111111111111111111111111111111111111111111111
11111111111111111111111111111111111111111111111111
11111111111111111111111111111111111111111111111111
11111111111111111111111111111111111111111111111111
11111111111111111111111111111111111111111111111111
