0000000000000000000000000000000000000000
0011111111111111111111111111111110000000
0111111111444444114444444441111111111000
0111111144444444444444422244444411111100
0011111111111111144222232244444411111000
0001111111111111114442222444444441111100
0001111114444444444222244444411111111000
0001114444222222222224444411111111110000
0001114422222222222224444411111111110000
0001111114422222322222222244444111100000
0000111144222222222222322444444444111000
0001114422222222222222441111111111111000
0000114422222222244444441111111111111000
0001111444444422224111111111111111111100
0000111111144444444111111111111111100000
0000001111144441111114444411111111100000
0000000001111111111111111111111111100000
0000000000000011111111111111111110000000
0000000000000000000000000000000000000000