44400000000000
22444111110000
23224144444000
22444142224000
22224444444000
44442222444000
44444444411000
22244111111000
22224111000000
44444110000000
00000000000000
00000000000000
00000000000000
00000000000000
00000000000000