000111111144444411444444411111111000
000111144422244422244422222244411100
000011111111111114422223224444441000
000001111111111111111222244442224100
000011111441444442222224444440000000
000011442222222224222444441110000000
000011442222222224222444441110000000
000011442221122222242224444411100000
000011442221111112222224422224441000
000111112222224222444441110000000000
000011442222222224411111110000000000
000111144444442222411111110000000000
000011111114444444411111110000000000
000000000044441111114444400000000000
000000000000001111111100000000000000
000000000000001111100000000000000000
000000000000000000000000000000000000