00000000000000
00111111110000
00001111110000
00111110001000
00001111111000
11110000111000
11111111111000
00011111111000
00001111000000
11111110000000
00000000000000
00000000000000
00000000000000
00000000000000
00000000000000