1111111111111111111111111111111111111111
1111111111111111111111111111111111111111
1111111111111111111111111111111111111111
1111111111111111111111111111111111111111
1111111111111111111111111111111111111111
1111111111111111111111111111111111111111
1111111111111111111111111111111111111111
1111111111222222112222222221111111111111
1111111122222222222222222233333311111111
1111111111111111133222222233333331111111
1111111111111111113332222333333331111111
1111111113333333333222233333311111111111
1111113333222222222223333311111111111111
1111113322222222222223333311111111111111
1111111113322222222222222233333111111111
1111111133222222222222222333333333111111
1111113322222222222222333311111111111111
1111113322222222233333331111111111111111
1111111333333322223331111111111111111111
1111111111133333333111111111111111111111
1111111111133333311133333311111111111111
1111111111111111111111111111111111111111
1111111111111111111111111111111111111111
1111111111111111111111111111111111111111
1111111111111111111111111111111111111111
1111111111111111111111111111111111111111
1111111111111111111111111111111111111111
1111111111111111111111111111111111111111
