000111111144444411444444444111111000
000111144444444444444422244444411100
000011111111111114422223224444441000
000001111111111111444222244444444100
000011111444444444422224444440000000
000011444422222222222444441110000000
000011442222222222222444441110000000
000011442222232222222224444411100000
000011442222222222223224444444441000
000111442222222222222244110000000000
000011442222222224444444110000000000
000111144444442222411111110000000000
000011111114444444411111110000000000
000000000044441111114444400000000000
000000000000001111111100000000000000
000000000000001111100000000000000000
000000000000000000000000000000000000